r........A
ooooooooo.
oD.....Eo.
o.ooooo.o.
o.oH.Io.o.
o.o.oko.o.
o.o.ooo.o.
o.oG...Fo.
o.ooooooo.
oC.......B
